R 1922 1282
NO textures/redbrick.xpm
SO textures/redbrick.xpm
WE textures/redbrick.xpm
EA textures/redbrick.xpm
S textures/vacuum.xpm
F 211,211,211C 125,125,125
111111111111111111111
100000000000000000001
100000000000000000001
10000000000000000000111111111
11111111100000000000000000001
10000000000000000000000000001
10000000000000000000000000001
10000000000000000000000000001
10000000020000000000000000001
10000000000000000000000000001
10000000000000000000000000001
100000000000000000000000E0001
10000000000000000000000000001
11111111111111111111111111111
