R 1922 1282
NO textures/redstone_ore.xpm
SO textures/gold_ore.xpm
WE textures/emerald_ore.xpm
EA textures/diamond_ore.xpm
S  textures/creeper.xpm
F 211,211,211C 125,125,125
11111111111
100000S0001
10000000001
10000000001
10000000001
10000000001
10000000001
10200002001
10000000001
10000000001
10000200001
10000000001
10000000001
10000000001
10000000001
10000000001
10000100101
10000020001
11111111111
