R 1920           1080
NO textures/monke1.xpm
SO               textures/monke1.xpm
WE textures/monke3.xpm





EA textures/fuma.xpm

S  textures/banana.xpm
F 139,69,19C      34,139,34





NO textures/monke1.xpm





111111111111
10000W000001
100000000001
100000000001
111000000001
111000020001
111000000001
111000000001
100000001111
100000001111
111000000001
111000000001
100000111111
100000011111
111000000001
111000020001
111000020001
111000000001
100000000001
100000111111
100000111111
100000111111
100000111111
100000111111
100200111111
100000111111
100000000001
111000000001
111000000001
100002000001
100000000001
100000000001
100200111111
100000111111
100000111111
100000111111
100000111111
100000111111
100000111111
100000111111
100000111111
100002111111
111111111111
