R 1000 1000
NO textures/redstone_ore.xpm
SO textures/diamond_ore.xpm
WE textures/emerald_ore.xpm
EA textures/gold_ore.xpm
S textures/torch1.xpm
F 211,211,211C 125,125,125
111
10111111111   1111111111111111111
10000000001   101110020000000001
12001111101   101 100011111111111111111111
1000001 101   101110001
10001111101   100000001
10000000001   111111101
10S00000111         101
100000011  111111111101
10000201   100000000021
10000001   101111111111
10101001   101
12000001111101   111
10000000000021   101
11111111111111   111
